//MAP CONVERTED BY dmm2tgm.py THIS HEADER COMMENT PREVENTS RECONVERSION, DO NOT REMOVE
"a" = (
/turf/template_noop,
/area/template_noop)
"b" = (
/turf/simulated/floor/plating/asteroid/basalt/lava_land_surface,
/area/lavaland/surface/outdoors/unexplored)
"c" = (
/obj/item/clockwork/alloy_shards/small,
/turf/simulated/floor/plating/asteroid/basalt/lava_land_surface,
/area/lavaland/surface/outdoors/unexplored)
"d" = (
/obj/structure/clockwork/wall_gear,
/turf/simulated/floor/plating/asteroid/basalt/lava_land_surface,
/area/lavaland/surface/outdoors/unexplored)
"e" = (
/obj/item/stack/tile/brass,
/turf/simulated/floor/clockwork{
	nitrogen = 23;
	oxygen = 14;
	temperature = 300
	},
/area/lavaland/surface/outdoors/unexplored)
"f" = (
/turf/simulated/mineral/volcanic/lava_land_surface,
/area/lavaland/surface/outdoors/unexplored)
"g" = (
/obj/item/clockwork/alloy_shards/medium/gear_bit,
/turf/simulated/floor/plating/asteroid/basalt/lava_land_surface,
/area/lavaland/surface/outdoors/unexplored)
"h" = (
/turf/simulated/floor/clockwork{
	nitrogen = 23;
	oxygen = 14;
	temperature = 300
	},
/area/lavaland/surface/outdoors/unexplored)
"i" = (
/obj/structure/grille/ratvar/broken,
/turf/simulated/floor/plating/asteroid/basalt/lava_land_surface,
/area/lavaland/surface/outdoors/unexplored)
"j" = (
/turf/simulated/wall/clockwork,
/area/lavaland/surface/outdoors/unexplored)
"k" = (
/obj/item/clockwork/alloy_shards/small,
/turf/simulated/floor/clockwork{
	nitrogen = 23;
	oxygen = 14;
	temperature = 300
	},
/area/lavaland/surface/outdoors/unexplored)
"l" = (
/turf/simulated/floor/plating/lava/smooth/lava_land_surface,
/area/lavaland/surface/outdoors/unexplored)
"m" = (
/obj/item/clockwork/alloy_shards/medium,
/turf/simulated/floor/plating/asteroid/basalt/lava_land_surface,
/area/lavaland/surface/outdoors/unexplored)
"n" = (
/obj/item/clockwork/component/belligerent_eye/blind_eye,
/turf/simulated/floor/plating/asteroid/basalt/lava_land_surface,
/area/lavaland/surface/outdoors/unexplored)
"o" = (
/obj/item/clockwork/alloy_shards/large,
/turf/simulated/floor/plating/asteroid/basalt/lava_land_surface,
/area/lavaland/surface/outdoors/unexplored)
"p" = (
/obj/item/clockwork/alloy_shards/medium,
/turf/simulated/floor/clockwork{
	nitrogen = 23;
	oxygen = 14;
	temperature = 300
	},
/area/lavaland/surface/outdoors/unexplored)
"q" = (
/obj/structure/lattice/catwalk/clockwork,
/turf/simulated/floor/plating/lava/smooth/lava_land_surface,
/area/lavaland/surface/outdoors/unexplored)
"r" = (
/obj/structure/lattice/clockwork,
/turf/simulated/floor/plating/asteroid/basalt/lava_land_surface,
/area/lavaland/surface/outdoors/unexplored)
"s" = (
/obj/item/clockwork/alloy_shards/large,
/turf/simulated/floor/clockwork{
	nitrogen = 23;
	oxygen = 14;
	temperature = 300
	},
/area/lavaland/surface/outdoors/unexplored)
"t" = (
/turf/space,
/area/space)
"u" = (
/obj/structure/grille/ratvar,
/turf/simulated/floor/clockwork{
	nitrogen = 23;
	oxygen = 14;
	temperature = 300
	},
/area/lavaland/surface/outdoors/unexplored)
"v" = (
/obj/item/clockwork/alloy_shards/medium,
/obj/structure/lattice/clockwork,
/turf/simulated/floor/plating/asteroid/basalt/lava_land_surface,
/area/lavaland/surface/outdoors/unexplored)
"w" = (
/obj/structure/grille/ratvar/broken,
/turf/simulated/floor/clockwork{
	nitrogen = 23;
	oxygen = 14;
	temperature = 300
	},
/area/lavaland/surface/outdoors/unexplored)
"x" = (
/obj/structure/clockwork/wall_gear,
/obj/item/stack/tile/brass,
/turf/simulated/floor/clockwork{
	nitrogen = 23;
	oxygen = 14;
	temperature = 300
	},
/area/lavaland/surface/outdoors/unexplored)
"y" = (
/obj/item/clockwork/component/geis_capacitor/fallen_armor,
/turf/simulated/floor/clockwork{
	nitrogen = 23;
	oxygen = 14;
	temperature = 300
	},
/area/lavaland/surface/outdoors/unexplored)
"z" = (
/obj/structure/clockwork/wall_gear,
/turf/simulated/floor/clockwork{
	nitrogen = 23;
	oxygen = 14;
	temperature = 300
	},
/area/lavaland/surface/outdoors/unexplored)
"A" = (
/obj/item/clockwork/alloy_shards/clockgolem_remains,
/turf/simulated/floor/clockwork{
	nitrogen = 23;
	oxygen = 14;
	temperature = 300
	},
/area/lavaland/surface/outdoors/unexplored)
"B" = (
/obj/item/clockwork/weapon/ratvarian_spear,
/turf/simulated/floor/clockwork{
	nitrogen = 23;
	oxygen = 14;
	temperature = 300
	},
/area/lavaland/surface/outdoors/unexplored)
"C" = (
/obj/item/clockwork/alloy_shards/medium/gear_bit,
/turf/simulated/floor/clockwork{
	nitrogen = 23;
	oxygen = 14;
	temperature = 300
	},
/area/lavaland/surface/outdoors/unexplored)
"D" = (
/obj/structure/grille/ratvar,
/turf/simulated/floor/plating/asteroid/basalt/lava_land_surface,
/area/lavaland/surface/outdoors/unexplored)
"E" = (
/obj/item/clockwork/alloy_shards/clockgolem_remains,
/turf/simulated/floor/plating/asteroid/basalt/lava_land_surface,
/area/lavaland/surface/outdoors/unexplored)
"F" = (
/obj/structure/dead_ratvar,
/turf/simulated/floor/clockwork{
	nitrogen = 23;
	oxygen = 14;
	temperature = 300
	},
/area/lavaland/surface/outdoors/unexplored)
"G" = (
/obj/item/stack/tile/brass/fifty,
/turf/simulated/floor/plating/asteroid/basalt/lava_land_surface,
/area/lavaland/surface/outdoors/unexplored)

(1,1,1) = {"
a
a
a
a
a
a
a
a
a
a
a
a
a
b
s
h
b
a
a
a
a
a
a
a
"}
(2,1,1) = {"
a
a
a
a
a
a
a
o
b
a
h
b
r
c
j
x
b
b
g
a
a
a
a
a
"}
(3,1,1) = {"
a
a
a
a
a
a
f
b
l
b
v
b
p
w
j
j
c
l
b
b
a
a
a
a
"}
(4,1,1) = {"
a
a
a
a
a
a
f
l
l
r
b
b
l
j
j
j
p
l
b
h
c
r
a
a
"}
(5,1,1) = {"
a
a
a
a
l
b
b
p
r
F
b
h
A
b
j
l
b
l
l
D
h
r
a
a
"}
(6,1,1) = {"
a
a
a
h
l
l
b
h
k
h
h
h
r
l
w
l
l
l
m
c
h
f
a
a
"}
(7,1,1) = {"
a
a
b
b
b
l
q
r
h
h
h
c
q
l
l
l
l
l
l
c
f
f
b
a
"}
(8,1,1) = {"
a
h
h
g
p
s
r
h
h
h
h
h
h
h
l
b
l
l
l
l
f
b
a
a
"}
(9,1,1) = {"
a
b
c
b
b
h
h
k
h
h
h
h
h
c
p
b
g
l
l
b
b
b
b
a
"}
(10,1,1) = {"
b
h
l
l
h
h
t
t
t
t
t
k
B
h
t
t
t
l
l
l
m
l
l
a
"}
(11,1,1) = {"
c
i
j
j
h
h
t
t
t
t
t
h
s
b
t
t
t
l
l
l
l
l
b
a
"}
(12,1,1) = {"
d
j
j
j
h
h
t
t
t
t
t
h
b
s
t
t
t
b
l
l
b
h
o
a
"}
(13,1,1) = {"
e
k
b
l
h
h
t
t
t
t
t
r
k
b
t
t
t
l
l
l
l
b
b
a
"}
(14,1,1) = {"
b
b
b
m
h
h
t
t
t
t
t
h
r
j
t
t
t
b
l
l
b
b
h
b
"}
(15,1,1) = {"
b
b
b
l
h
h
t
t
t
t
t
o
b
l
t
t
t
l
l
l
l
b
b
a
"}
(16,1,1) = {"
f
l
l
l
h
h
t
t
t
t
t
y
l
l
t
t
t
l
l
l
l
f
f
a
"}
(17,1,1) = {"
b
b
b
l
h
h
t
t
t
t
t
h
m
b
t
t
t
r
l
r
l
l
b
a
"}
(18,1,1) = {"
b
h
l
l
o
j
u
r
p
h
r
h
b
l
t
t
t
C
r
h
b
b
m
b
"}
(19,1,1) = {"
b
b
l
l
h
h
h
t
t
t
t
t
t
t
t
t
t
h
c
h
r
h
b
b
"}
(20,1,1) = {"
b
l
l
l
c
h
k
t
t
t
t
t
t
t
t
t
t
l
l
b
E
r
G
o
"}
(21,1,1) = {"
g
b
l
l
r
h
h
t
t
t
t
t
t
t
t
t
t
l
l
l
l
j
j
r
"}
(22,1,1) = {"
c
c
b
l
b
h
h
t
t
t
t
t
t
t
t
t
t
l
l
l
h
j
j
j
"}
(23,1,1) = {"
b
h
m
n
b
h
l
t
t
t
t
t
t
t
t
t
t
l
l
b
b
w
r
b
"}
(24,1,1) = {"
a
a
b
b
l
l
l
j
j
q
p
h
m
e
z
j
j
l
l
c
l
l
b
a
"}
(25,1,1) = {"
a
a
a
l
l
l
l
j
l
l
b
h
r
x
h
l
l
l
l
l
l
a
a
a
"}
(26,1,1) = {"
a
a
a
c
b
l
l
l
l
l
l
g
q
b
h
l
l
l
c
m
b
a
a
a
"}
(27,1,1) = {"
a
a
a
b
h
b
l
l
l
l
l
l
l
l
l
l
l
l
l
b
a
a
a
a
"}
(28,1,1) = {"
a
a
a
a
c
b
l
b
l
l
l
l
l
l
l
l
b
l
f
a
a
a
a
a
"}
(29,1,1) = {"
a
a
a
a
b
b
f
c
b
l
c
l
l
l
l
c
o
l
b
a
a
a
a
a
"}
(30,1,1) = {"
a
a
a
a
a
g
c
b
l
l
b
m
l
b
l
f
b
a
a
a
a
a
a
a
"}
(31,1,1) = {"
a
a
a
a
a
a
a
b
l
b
a
b
l
c
f
f
a
a
a
a
a
a
a
a
"}
(32,1,1) = {"
a
a
a
a
a
a
a
a
a
a
a
a
a
a
c
a
a
a
a
a
a
a
a
a
"}
